 ####
##  #####
#  $  $ #
# $*..* ##
#  *$$.  #
#@ *.*.  #
####   ###
   #####